CCCCCCCCCCCCCCCCCCCCCCCCCCCCCCCCCCCCCCCCCCCCCCCCCCCCCCCCCCCCCCCCCCCCCCCCCCCCCCCCCCCCCCCCCCCCCCCCCCCCCCCCCCCCCCCCCCCCCCCCCCCCCCCCCCCCCCCCCCCCCCCCCCCCCCCCCCCCCCCCCCCCCCCCCCCCCCCCCCCCCCCCCCCCCCCCCCCCCCC
CCCCCCCCCCCCCCCCCCCCCCCCCCCCCCCCCCCCCCCCCCCCCCCCCCCCCCCCCCCCCCCCCCCCCCCCCCCCCCCCCCCCCCCCCCCCCCCCCCCCCCCCCCCCCCCCCCCCCCCCCCCCCCCCCCCCCCCCCCCCCCCCCCCCCCCCCCCCCCCCCCCCCCCCCCCCCCCCCCCCCCCCCCCCCCCCCCCCCCC
N.....T.N..................................................................................M......................................................................................Mf........XXXXXFFFX.m
N.HG..T.N.......................................................A..........................M......................................................................................Mf........X.X.XI.YX.m
N.....T.N.........WWW................WW..W.............................................WXXXM......NNNNNNNNNNNNNN..................................................................Mf......a.X.X.X..YX.m
NFFFF.T.N....................W...........N.....................WW....................NNN...M......NXXXXXXXXXXXXN..................................................................Mf........XXXYYYYYX.m
N.....T.N..WW.....WW.....................WWWWWWWWW..................WW.....WW......WWWWWW..M......WWWWWWWWWWWWWW..................................................................X.ff......ffffXXXXX.m
N.....T.N.........ww.............WW......W.......W..............................WWWWWWWWW..MWW.................X..........FFFFFFFFFFFFFFFFFFFFFFF.............................a...X...ff..............m
N.....T.N...............................WW.A.....W..............................WWWWWWWWW..M...................X.............................................................ff...X.....ff............m
N..A..T.N.....WW.........................W.X.....W..............WWWWWWWWXXXXXXXXXWWWWWWWW..M...................W..................................FF..........FF..................M.......fffffff.....m
N.....................M...........WW.....W.....XXW..............W........WWWWWWWWWWWWWWWW..M......WWWWWWWWWWWWWW....................A............................................fM........f..........m
N......................nWWWWW.............WXX.....W............WWW................WWWWWW...M......WXXXXXXXXXXXXW..............WWWWWWWWWWWW.............FF.........................M........f..........m
N...................WWW.A..W.............W.......W.............WW...A......................M.....WWWWWWWWWWWWWWW........FF....W..........WFF.................................ff...M........f.....fffffm
N.T...T...........WWW.....WWWWWWWWWWWWWWW.....XXWnWWWWWWWWWWWWWWW.........................XXX....WWWWWWWWWWWWWWW............WW...........W.............................FF.........M........f..........m
N.T...T.........WWnN.......XXXXXXXXXXXXXXX......XX...XX.....XX........XXXXXXX......XX...XXXXX................................W...........W.....FF...........A....................fM........fff........m
N.T...T.WWWWWWWWnnnN.......XXXXXXXXXXXXXXX..............................XXXXXXX......XX..XXXX..................W.....WW.....WWWWWWWWWWWWWW........................................M...................m
N.T...T.XXXXXXXXMnnnWWWWWWWWWWWWWWWWWWWWWWWWWWWWWWWWWWWWWWWWWWWWWWWWWWWWWWWWWWWWWWWWWWWWWWWWWWWWWWWWWWW........W..............XXXXXXXXXXXX...........FF............FF........ff...M..............fffffm
NWW...T.XXXXXXXXM.............................................................................................WW........A.....XXXXXXXXXXXX........................................M..............nnnnnm
N.T...T.XXXXXXXX..............................................................................................WW..............XXXXXXXXXXXX.......................................fM............nnnnnnnm
nWWWWWWWWWWWWWWWWWWWWWWWWWWWWWWWWWWWWWWWWWWWWWWWWWWWWWWWWWWWWWWWWWWWWWWWWWWWWWWWWWWWWWWWWWWWWWWWWWWWWWWWWWWWWWWWWWWWWWWWWWWWWWWWWWWWWWWWWWWWWWWWWWWWWWWWWWWWWWWWWWWWWWWWWWWWWWWWWWWWWWWWWWnnnnnnnnnnnnm