CCCCCCCCCCCCCCCCCCCCCCCCCCCCCCCCCCCCCCCCCCCCCCCCCCCCCCCCCCCCCCCCCCCCCCCCCCCCCCCCCCCCCCCCCCCCCCCCCCCCCCCCCCCCCCCCCCCCCCCCCCCCCCCCCCCCCCCCCCCCCCCCCCCCCCCCCCCCCCCCCCCCCCCCCCCCCCCCCCCCCCCCCCCCCCCCCCCCCCC
CCCCCCCCCCCCCCCCCCCCCCCCCCCCCCCCCCCCCCCCCCCCCCCCCCCCCCCCCCCCCCCCCCCCCCCCCCCCCCCCCCCCCCCCCCCCCCCCCCCCCCCCCCCCCCCCCCCCCCCCCCCCCCCCCCCCCCCCCCCCCCCCCCCCCCCCCCCCCCCCCCCCCCCCCCCCCCCCCCCCCCCCCCCCCCCCCCCCCCC
N.....................................................................................................................................................................................................N
N.....................................................................................................................................................................................................N
N.HG..................................................................................................................................................................................................N
N.....................................................................................................................................................................................................N
N.....................................................................................................................................................................................................N
N.....................................................................................................................................................................................................N
N.....................................................................................................................................................................................................N
n.....................................................................................................................................................................................................N
n.....................................................................................................................................................................................................N
N.....................................................................................................................................................................................................N
N.....................................................................................................................................................................................................N
N.....................................................................................................................................................................................................N
N.....................................................................................................................................................................................................N
N.....................................................................................................................................................................................................N
N.....................................................................................................................................................................................................N
N.....................................................................................................................................................................................................N
N.....................................................................................................................................................................................................N
FFFFFFFFFFFFFFFFFFFFFFFFFFFFFFFFFFFFFFFFFFFFFFFFFFFFFFFFFFFFFFFFFFFFFFFFFFFFFFFFFFFFFFFFFFFFFFFFFFFFFFFFFFFFFFFFFFFFFFFFFFFFFFFFFFFFFFFFFFFFFFFFFFFFFFFFFFFFFFFFFFFFFFFFFFFFFFFFFFFFFFFFFFFFFFFFFFFFFFN